25
-------------------------------------------------------------------------------------------------------
-------------------------------------------------------------------------------------------------------
-------------------------------------------------------------------------------------------------------
-----*-------*------*********------************-------*-------------*----------------------------------
-----*------*-------*--------*----------*-------------*-------------*-----------------------------------
-----*-----*--------*---------*---------*-------------*-------------*-----------------------------------
-----*----*---------*----------*--------*-------------*-------------*-----------------------------------
-----*---*----------*-----------*-------*-------------*-------------*-----------------------------------
-----*--*-----------*-----------*-------*-------------*-------------*-----------------------------------
-----*-*------------*----------*--------*-------------*-------------*-----------------------------------
-----**-------------** * * * *----------*-------------*-------------*-----------------------------------
-----*-*------------*---------*---------*-------------*-------------*-----------------------------------
-----*--*-----------*----------*--------*-------------*-------------*-----------------------------------
-----*---*----------*-----------*-------*-------------*-------------*-----------------------------------
-----*----*---------*------------*------*-------------*-------------*-----------------------------------
-----*-----*--------*-------------*-----*-------------*-------------*-----------------------------------
-----*------*-------*------------*------*-------------*-------------*-----------------------------------
-----*-------*------*-----------*-------*-------------*-------------*-----------------------------------
-----*--------*-----*----------*--------*--------------*-----------*------------------------------------
-----*---------*----*---------*---------*---------------* * * * * *-------------------------------------
-----*----------*---** * * * *----------*---------------------------------------------------------------
--------------------------------------------------------------------------------------------------------
--------------------------------------------------------------------------------------------------------
--------------------------------------------------------------------------------------------------------
--------------------------------------------------------------------------------------------------------
--------------------------------------------------------------------------------------------------------