#########..........................................................##########
#...........................................................................#
#...........................................................................#
.............................................................................
.............................#................#..............................
.............................#................#..............................
.............................#................#..............................
.................#############................############...................
.............................................................................
.............................................................................
.............................................................................
.............................................................................
.............................................................................
.................#############................############...................
.............................#................#..............................
.............................#................#..............................
.............................#................#..............................
.............................................................................
#...........................................................................#
#...........................................................................#
#########...........................................................#########